EEEWWWWWWWWWWWWWWWWWWWWWWWWWWWWWWWWWWWWWWWWWWWWWWWWWWWWWWWWWWWWWWWWWWWWWWWWWWWWW
E                                     W             W                          E
E                                     W             W                          E
W                                     W             W                          W
W                                     W             W                          W
W                                     W             W                          W
W                                     W             W                          W
W                                     W             W                          W
W                   WWWWWWW           W             W                          W
W                WWWW                 W             W                          W
W               WW                    W             W            WWWW      WWWWW
W             WWW                     W             W            W             W
W            WW                       W             W            W             W
W           WW                        W             WWWWWWWWWWWWWW             W
W          WW                         W             W                          W
W         WW                          W             W                          W
W         W                           W             W                          W
W        WW                           W             W                          W
W       WW                            W             W                          W
W       W                             WWWWWWW   WWWWW                          W
W      WW          WWWWWWWWWWW                                                 W
W      W           WWWWWWWWWWW                                                 W
W      W           WWWWWWWWWWW                                                 W
W     WW           WWWWWWWWWWW                                                 W
W     W            WWWWWWWWWWW                                    WWW    WWWWWWW
W     W            WWWWWWWWWWW                                    W            W
W     W            WWWWWWWWWWW                                    W            W
W    WW            WWWWWWWWWWW                                    W            W
W    W             WWWWWWWWWWW        WWW     WWWWWWWWWWWWWWWWWWWWW            W
W    W             WWWWWWWWWWW        W                           W            W
W    W                                W                           W            W
W   WW                                W                           W            W
W   W                                 W                           W            W
W   W                                 W                           W            W
W   W                                 W                           W            W
W   W                                 W                           W            W
W   W                                 W                           W            W
W   W                                 W                           W            W
W   W                                 W                           W            W
WWWWWWWWWWWEEEEWWWWWWWWWWWWWWWWWWWWWWWWWWWWWWWWWEEWWWWWWWWWWWWWWWWWWWWWWEEWWWWWW