WWWWWWWWWWWWWWWWWWWWWWWWWWWWWWWWWWWWWWWWWWWWWWWWWWWWWWWWWWWWWWWWWWWWWWWWWWWWWWWW
W                                                                              W
W                                                                              W
W                                                                              W
W                                                                              W
W                                                                              W
W                                                                              W
W                                                                              W
W                                                                              W
W                                                                              W
W                                                                              W
W     WW       WWWWWWWWWWWWWWWWWWWWWWWWWWWWWWWWWWWWWWWWWWWWWWWWW       WW      W
W     WW       W                                               W       WW      W
W              W                                               W               W
W              W                                               W               W
W              W                                               W               W
W              W                                               W               W
W              W                                               W               W
W              W                                               W               W
W              W                                               W               W
W                                                                              W
W                                                                              W
W                                                                              W
W                                                                              W
W                                                                              W
W                                                                              W
W     WW       WW      WW        WW        WW        WW       WW       WW      W
W     WW       WW      WW        WW        WW        WW       WW       WW      W
W     WW       WWWWWWWWWW        WWWWWWWWWWWW        WWWWWWWWWWW       WW      W
W      W                                                               W       W
W      W                                                               W       W
W      W                                                               W       W
W      W                                                               W       W
W      W                                                               W       W
W      W                                                               W       W
W                                                                              W
W                                                                              W
W                                                                              W
W                                                                              W
WWWWWWWWWWWWWWWWWWWWWWWWWWWWWWWWWWWWWEEEEEWWWWWWWWWWWWWWWWWWWWWWWWWWWWWWWWWWWWWW