WWWWEEWWWWWWWWWW
W              W
W              W
W  W           E
W  W           E
W  WW   WWWWWWWW
W  W           W
E              E
E              E
W         W    W
W   WWW   W    W
W   WWW   W    W
W   WWW   W    W
W         W    W
W         W    W
WWEEWWWWWWWWEEWW





