WWWWEEWWWWWWWWWW
W              W
W              W
W  W           W
W  W           W
W  WW   WWWWWWWW
W  W           W
W              W
W              W
W         W    W
W   WWW   W    W
W   WWW   W    W
W   WWW   W    W
W         W    W
W         W    W
WWWWWWWWWWWWWWWW





