WWWWW
W   W
WW WW
W  WW
W WWW
W WWW
W  EW
WWWWW